AA	Ʌʌ	Αα	ᗑ
AE	Ææ	Ǝⱻ	ɘ
AH	Ɐɐ
AO	Åå
AW	Ɑɑ
AY	Ɐɐ
B	Бб	β	3	ß	Bʙ	Ʒʒ	Ээ	ẞß
CH	τʃ
D	Δδ	Дд	ϑδ	ȡ
DH	Ðđ	Þþ	Ðð
EH	Ɛɛ	Σε	Ξξ	Ɛɛ	Ԑԑ	Єє	Ƹƹ	Εϵε
ER	ɚ	ɝ
EY	ɘɘ
F	Φϕφ	Ⅎⅎ	Ϝϝ	ϕ	Ƒƒ
G	Gɢ
HH	Ԋԋ
IH	Iı	ɪɪ	Ɩɪıɩɩι
IY	İi	Ɨɨ
JH	ʤɟȷ	Ɉɉ	Ĵjɟʝ
K	Kκƙʞ
L	λ	Лл	ℓ	Ƚƚ	ɫɬ	Ϟϟ	ȴ
M	Mмʍ
N	Nɴ	Ƞƞ	Ии
NG	Ŋŋ	ȵ
OW	Ωω	Ɔɔ
OY	Œœ	Øø
P	Ψᴪ	Ппπ	Pᴘ
R	Rʀ	Яя	ſ
S	ЗЭз
SH	Ʃʃ
T	τ	Ƭƭ	Tᴛ	Ⱶⱶ
TH	Ħħ	Ŧŧ	Θθ	Ћћ	Þþ
UH	Əə	Ωω	Ʊʊ
UW	Øø
V
W	Шш	Łł	Ƿƿ	Ɯɯ	Ⱳⱳ
Y	Yʏ	Jj	ɣƔɣɤɤ	Чч	Уу
Z	Ƨƨ	Зз	Ƶƶ
ZH	Жж	Çç	Ʒʒ	ʐʑ

GH	Ȝȝ	ᵹ	Ɣɣ	ɤɤ


TS	ʦʦ
DZ	ǲǳ
LJ	ǈǉ
NJ	ǋǌ
UE	ᵫ
Ƌƌ	nd
JH	ʤ
CH	ʧ
OU	Ȣȣ
OI	Ƣƣ