B	b
CH	ts
D	d
DH	đ
ER	r
F	f
G	ɡ
HH	h
JH	dj
K	k
L	ʌ
M	m
N	n
NG	ng
P	p
R	r
S	c
SH	z
T	t
TH	ħ
V	v
W	w
Y	y
Z	s
ZH	j
AA	a
AE	æ
AH	ə
AO	o
EH	e
IH	ı
IY	i
UH	ɤ
UW	u
AW	aɤ
AY	ai
EY	ei
OW	oɤ
OY	oi

